AGORAPHOBIC	AH G OW R AE P HH OW B IH K
AI'S	EY AY Z
ALIEN'	EY L IY AH N
ANGKOR	AE N G K AH R	
ASBC	AH EH S B IY S IY
ASTERN	AH S T ER N
AT'	AE T
ATTACHMEN	AH T AE CH M AH N T
AUBERGINE	OW B AH R JH IY N
AUDIENCE'	AA D IY AH N S
AUDIENCE'(2)	AO D IY AH N S
AWW	AO W
BACKSTABBER	B AE K S T AE B ER
BC	B IY S IY
BERTHING	B ER TH IH NG
BESTEST	B EH S T AH S T
BETTEREST	B EH T ER AH S T
BLOGS	B L AA G Z
BURPED	B AH R P T
CAN'	K AE N
CAN'(2)	K AH N
CENTS'	S EH N T S
CENTS'(2)	S EH N S
CFO	S IY EH F OW
CLOUDLIFE	K L AW D L AY F
CLOUDLIFE'S	K L AW D L AY F S
CONTAINMENTS	K AH N T EY N M AH N T S
CSR	S IY EH S AA R
DECOMPRESS	D IY K AH M P R EH S
DIDN	D IH D AH N T
DIGITIZES	D IH JH AH T AY Z IH Z
DIVIDERS	D AH V AY D ER Z
DOIGN	D UW IH NG
DOUT	D AW T
DUEING	D UW IH NG
DUSTBIN'	D AH S T B IH N
DUSTIN'S	D AH S T IH N Z
EMBARGOS	IH M B AA R G OW Z
ENTRY'S	EH N T R IY Z
EREADER	IY R IY D AH R
ETA	IY T IY AH 
EXCITINGEST	IH K S AY T IH NG AH S T
EXCITINGS	IH K S AY T IH NG Z
EXICITING	IH K S AY T IH NG
EXPENSIVEST	EH K S P EH N S IH V AH S T
EXPENSIVESTED	EH K S P EH N S IH V AH S T IH D
FILMSTAR	F IH L M S T AA R
FLYSAFE	F L AY S EY F
FTC	EH F T IY S IY
GANTRIES	G AE N T R IY Z
GREENGRASS	G R IY N G R AE S
HEADSCARF	HH EH D S K AA R F
HEADSORE	HH EH D S OW R
IBX	AY B IY EH K S
KASEEM	K EY S IY M
KASEEM'S	K EY S IY M Z
KL	K EY EH L
LEAKINGS	L IY K IH NG Z
LET'SSOCIALIZE	L EH T S OW SH AH L AY Z
LIFEBUOYS	L AY F B OY Z
LIFEJACKET	L AY F JH AE K AH T
LIFT'	L IH F T
LIMEY	L AY M IY
LISA'	L IY S AH
LL	L
LOWERCASE	L OW ER K EY S
LOWEREST	L OW ER AH S T
MACCHU	M AE K UW
MALTE	M AE L T IY
MANYTHINGS	M EH N IY TH IH NG Z
MOTORWAY	M OW T ER W EY
MOVER'	M UW V ER
OPERATIONALIZED	AA P ER EY SH AH N AH L AY Z D
ORDERS'	AO R D ER Z
OSIRIS	AA S IY R IY Z
PANTS'	P AE N T S
PAVEMENT'	P EY V M AH N T
PHISHING	F IH SH IH NG
PMR	P IY EH M AA R
PODCASTS	P AA D K AE S T S
PORTBOARD	P OW R T B OW R D
POSTMODERNISM	P OW S T M AA D ER N IH Z AH M
POWERBOATS	P AW ER B OW T S
QUESTORMING	K W EH S T AO R M AH NG
R'	AA R
REBOOTING	R IY B UW T IH NG
REHANDLE	R IY HH AE N D AH L
RESTOWED	R IY S T OW D
RIVENIANS	R AH V IY N IY AH N Z
RSVP	AA R EH S V IY P IY
SATISFACTION'S	S AE T AH S F AE K SH AH N Z
SCULPTURE'S	S K AH L P CH ER Z
SEEMINGLINE	S IY M IH NG L AY N
SKATEBOARDER	S K EY T B OW R D ER
SKYDIVERS	S K AY D AY V ER Z
SLURPED	S L ER P T
SMARTPHONES	S M AA R T F OW N Z
SPLURGES	S P L ER JH IH Z
STORYBOARDING	S T OW R IY B OW R D IH NG
STOWAGE	S T OW IH JH
STOWAWAY	S T OW AH W EY
SURFS	S ER F S
SUSTAINABLE'	S AH S T EY N AH B AH L
SUVS	EH S Y UW V IY Z
TEAM'	T IY M
TEMPERATURE'S	T EH M P R AH CH ER Z
TOUSAND	TH AW Z AH N D
TWEETED	T W IY T AH D
UNBELIEVEABLE	AH N B AH L IY V AH B AH L
UNDERFED	AH N D ER F EH D
UNLIT	AH N L IH T
UNSELFISHLY	AH N S EH L F IH SH L IY
UNWATCHABLE	AH N W AA CH AH B AH L
UPPERCASE	AH P ER K EY S
UTC	Y UW T IY S IY
VHF	V IY EY CH EH F
WAYPOINT	W EY P OY N T
WEEKEND'	W IY K EH N D
WEEKEND'(2)	W IY K IH N D
WHITEBOARD	W AY T B OW R D
WIMPED	W IH M P T
WIMPING	W IH M P AH NG
WINDSCREEN	W IH N D S K R IY N
WINDSURFING	W IH N D S ER F IH NG
YOULL	Y UW L
ZAFIR	Z AE F AH R
ZEERO	Z IH R OW
