LASAGNE	L AH Z AH N Y AH
QUARTERMASTER'S	K W AO R T ER M AE S T ER Z
ANTIVIRUS	AE N T AY V AY R AH S
DJS	D IY JH EY S
LOCSTAT	L AA K S T AH T
WORKMATES	W ER K M EY T S
KIKO	K IH K OW
APARTMENT'S	AH P AA R T M AH N T S
EMOTIBOT	AH M AA T AH B AH T
HI'	HH AY
UNTS	AH N T S
EXECUTABLE	EH K S AH K Y UW T AH B AH L
ULTRASOUNDS	AH L T R AH S AW N D Z
SENIORS'	S IY N Y ER Z
BRANDI'S	B R AE N D IY Z
EXPEDIENTLY	IH K S P IY D IY AH N T L IY
JANE'	JH EY N
TEENAGERS'	T IY N EY JH ER Z
DEPLANE	D IY P L EY N
SNOWBOARDING	S N OW B OW R D IH NG
RIVENIAN	R AH V IY N IY AH N
ACROPHOBIA	AE K R AH F OW B IY AH
TEAMBUILDING	T IY M B IH L D IH NG
DUVET	D Y UW V AH T
DJ	D IY JH EY
NO'	N OW
BRADCRY	B R AE D K R AY
SHIPPING'S	SH IH P IH NG Z
UK	Y UW K EY
EU	IY Y UW
CERMONY	S AH R M AH N IY
ESPRESSO'S	EH S P R EH S OW Z
COMPUTERCRAZY	K AH M P Y UW T ER K R EY Z IY
UA	Y UW EY
MICROPRINTING	M AY K R OW P R IH N T IH NG
DEMOTIVATED	D IY M OW T IH V EY T IH D
HIV	EY CH AY V IY
BLADERUNNERS	B L EY D R AH N ER Z
EIGTH	EY T TH
HYOPTHESIS	HH AY P AA TH AH S AH S
MMM	M M
COLDHEARTED	K OW L D HH AA R T IH D
COLLATED	K AH L EY T IH D
DOESN	D OW AH Z N
GREENWAY'S	G R IY N W EY Z
UFOS	Y UW EH F OW Z
TEASHOP	T IY SH AA P
CAPTAINED	K AE P T AH N D
SHOW'LL	SH OW L
SHOULDN	SH UH D AH N T
FY	EH F W AY
ELLIPSIS	IH L IH P S AH S
SEMICOLON	S EH M IY K OW L AH N
INT	IH N T
SUNRAY	S AH N R EY
ASPIRINS	AE S P R AH N Z
ABSEILING	AE B S IY AH L AH NG
SIMILES	S IH M AH L IY Z
FLORIST'S	F L AA R AH S T S
SUNDAES	S AH N D EY Z
NOTEPAPER	N OW T P EY P ER
PPTS	P IY P IY T IY S
UNTHOUGHTFUL	AH N TH AO T F AH L
INSTAB	IH N S T AE B
BRUSHSTROKES	B R AH SH S T R OW K S
CELLPHONES	S EH L F OW N Z
ABC	EY B IY S IY
GOING'	G OW IH NG
GOING'(2)	G OW IH N
PROBS	P R AA B Z
CEO	S IY IY OW
MOONBACKS	M UW N B AE K S
BLOG	B L AO G
GM	JH IY EH M
STOMACHACHES	S T AH M AH K EY K S
GEARSTICK	G IH ER S T IH K
CONDIMINIUM	K AA N D AH M IH N IY AH M
COSTWISE	K AO S T W AY Z
APORTS	AH P OW R T S
WHATCHAMACALLIT	W AH CH AA M AA K AO L IH T
COLLATING	K AH L EY T IH NG
REALLY'	R IH L IY
REALLY'(2)	R IY L IY
MATHS	M AE TH S
MINIBAR	M IH N IY B AA R
WALL'	W AO L
WEEK'	W IY K
XYZ	EH K S W AY Z IY
WIITHDRAW	W IH DH D R AO
CLAUSTROPHOBICS	K L AO S T R AH F OW B IH K S
PUSHBACK	P UH SH B AE K
MEGACAF	M EH G AH K AH F
DISSATISFYING	D IH S AE T AH S F AY IH NG
LEISUREWEAR	L EH ZH ER W AE ER
INFLAMMATORIES	IH N F L AE M AH T OW R IY Z
EARACHE	IH ER EY K
HERE'	HH IY R
SUBSTRUCTURE	S AH B S T R AH K CH ER
BLUETOOTH	B L UW T UW TH
BIRTHDAY'S	B ER TH D EY Z
COFFE	K AA F IY
CONVICITON	K AH N V IH K SH AH N
INT'REST	IH N T R AH S T
OK'	OW K EY
RIVENIA	R AH V IY N Y AH
INCONSIDERATE	IH N K AH N S IH D ER AH T
HILLWALKING	HH IH L W AO K IH NG
UNADVENTUROUS	AH N AH D V EH N CH ER AH S
HMM	EY CH EH M EH M
TIMEKEEPING	T AY M K IY P IH NG
VITAENERGY	V AY T AH EH N ER JH IY
MELOPREPPAN	M AH L AA P R EH P AH N
CHATROOMS	CH AE T R UW M Z
BA	B IY EY
PSYCHOMETRY	S AY K OW M IY T ER IY
PR	P IY AA R
FRANKIE'S	F R AE NG K IY Z
JACUZZIS	JH AH K UW Z IY Z
SWAN'S	S W AA N Z
WELLL	W EH L
PX	P IY EH K S
CRAWLER	K R AO L ER
SMARTPHONE	S M AA R T F OW N
ZOLMITRIPTAN	Z OW L M IH T R IH P T AH N
TREVI	T R EH V IY
BIGWORLD	B IH G W ER L D
CASEVACED	K EY S B EY S T
OVERCOOKED'	OW V ER K UH K T
DANNI	D AE N IY
SHUT'	SH AH T
SLEEPLESSNESS	S L IY P L AH S N AH S
UNVENTILATED	AH N V EH N T AH L EY T IH D
SFO	EH S EH F OW
CINDERELLA'S	S IH N D ER EH L AH Z
CRISPS	K R IH S P S
PARALEGAL'S	P EH R AH L IY G AH L Z
REINSTALLING	R IY IH N S T AH L IH NG
PERSREP	P ER Z R EH P
YOGHURT	Y OW G ER T
SPHYGMOMANOMETER	S F IH G M OW M IY T ER
AVIOPHOBIA	EY V IY AH F OW B IY AH
TIDINESS	T AY D IY N AH S
CLEARLY'	K L IH R L IY
SHHH	SH
THERES	DH EH R Z
AIRKING	AH IH R K IH NG
JACKET'S	JH AE K AH T S
ELITECH'S	EH L AH T AH K S
USABILITY	Y UW S AH B IH L AH T EH
TVS	T IY V IY S
VARNA	V AA R N AH
SUPERCARS	S UW P ER K AA R Z
MBAS	EH M B IY EY Z
WOAH	W OW
UPLOADED	AH P L OW D IH D
REFILLING	R IY F IH L IH NG
TOUCHSCREEN	T AH CH S K R IY N
PHARMACIST'S	F AA R M AH S IH S T S
WINDSOCK	W IH N D S AA K
BRIGHTCELL'S	B R AY T S EH L Z
FANTASTIC'	F AE N T AE S T IH K
BACKPACKING	B AE K P AE K IH NG
CP	S IY P IY
CM	S IY EH M
BASE'	B EY S
CK	S IY K EY
LUTELY	L UW T L IY
WHAY	W EY IY
GUARDROOM	G AA R D R UW M
BORNED	B AO R N D
PARACETEMOL	P AE R AH S EH T AH M AH L
STOVE'S	S T OW V Z
VARNA'S	V AA R N AH Z
STAFFROOM	S T AE F R UW M
POPCORN'S	P AA P K AO R N Z
ARACHNOPHOBIA	AH R AE K N AH F OW B IY AH
CEO'S	S IY IY OW Z
MD	EH M D IY
DETERGENTS'	D IH T ER JH AH N T S
START'	S T AA R T
PATISSERIE	P EY T IY Z ER IY
HANDWASH	HH AE N D W AA SH
SHIRT'S	SH ER T S
MP	EH M P IY
COMMUNALLY	K AH M Y UW N AH L IY
CHOLESTEROL'S	K AH L EH S T ER AO L Z
QUIRK'S	K W ER K S
TIDYING	T AY D IY IH NG
STOMACHACHE	S T AH M AH K EY K
PROMETHEUS	P R OW M EH DH IY AH S
REPELLANT	R IH P EH L AH N T
FEELING'S	F IY L IH NG Z
POWERNAPS	P AW ER N AE P S
DUNCAN'S	D AH NG K AH N Z
RECIPROCALLY	R IH S IH P R AH K AH L IY
BANDITEROS	B AE N D AH T ER OW S
AMBITOUS	AE M B AH T AH S
INTUREST	IH N T R AH S T
THEM'S	DH EH M Z
CARLO'S	K AA R L OW Z
FIINGERS	F IY N JH AH R Z
ME'	M IY
END'	EH N D
SUBWAY'S	S AH B W EY Z
SCEPTIC	S K EH P T IH K
CERTAINLY'	S ER T AH N L IY
CHAMOMILE	K AE M AH M IY L
MAYA'S	M AY AH Z
UTILITARIANISM	Y UW T IH L AH T EH R IY AH N IH Z AH M
LPS	EH L P IY S
CHALRIE	CH AA R L IY
SITREP	S IH T R EH P
MINIMILAST	M AH N AH M IH L AH S T
MARKLEX	M AA R K L AH K S
SLURPING	S L ER P IH NG
BESTPLAY	B EH S T P L EY
MELOPROPPAN	M AH L AA P R AA P AH N
SYMBOLIZATION	S IH M B AH L AH Z EY SH AH N
REFLEXOLOGY	R IY F L EH K S AA L AH JH IY
INLINE	IH N L AY N
OFFSITE	AO F S AY T
BRULEE	B R UW L EY
TURNS'	T ER N Z
DELICIOUS'	D IH L IH SH AH S
P.M	P IY EH M
PLACEMATS	P L EY S M AE T S
A.M	EY M
REFRAMING	R IY F R EY M IH NG
HR	EY CH AA R
TOOTHACHE	T UW TH EY K
HQ	EY CH K Y UW
MUM'S	M AH M Z
UNINSTALL	AH N IH N S T AO L
HUMANOID	HH Y UW M AH N OY D
MBA	EH M B IY EY
LEAVERS	L IY V ER Z
BLOODCURDLING	B L AH D K ER D L IH NG
SPICIER	S P AY S IY ER
BAGUA	B AE G W AH
FUNNILY	F AH N IY L IY
SOFA'S	S OW F AH Z
BRITNEY	B R IH T N IY
GERMINATING	JH ER M AH N EY T IH NG
DECK'	D EH K
TERRIFED	T EH R AH F AY D
UPLOAD	AH P L OW D
IT'	IH T
NECROPHOBIA	N EH K R AH F OW B IY AH
PICADILLY	P IH K AH D IH L IY
EMBEDDING	IH M B EH D IH NG
COLOUR	K AH L ER
A.D	EY D IY
DYNA	D IH N AH
B.C	B IY S IY
BABB'S	B AE B Z
HEL	HH EH L
IFACE	AY F AH S
WINKY	W IH NG K IY
TO'	T UW
TO'(2)	T IH
TO'(3)	T AH
HEDONIST	HH IY D AO N IH S T
TAKEAWAY	T EY K AH W EY
LIBURARY	L AY B R EH R IY
CHILLI	CH IH L IY
PAGE'	P EY JH
LATERS	L EY T ER Z
VP'S	V IY P IY S
GOTTA'VE	G AA T AH V
SCEPTICAL	S K EH P T IH K AH L
LIBRURARY	L AY B R EH R IY
LIB'RY	L IH B R IY
SEE'	S IY
FBI	EH F B IY AY
PAULO'S	P AO L OW Z
PDA	P IY D IY EY
BODYBUILDING	B AA D IY B IH L D IH NG
