TRAFFICKED	T R AE F IH K T
MOUSE'	M AW S
LEANNE	L IY N
KASBA	K AE S B AH
UCLA	 Y UW S IY EH L EY
FOWER	F OW AH R
SUDOKU	S UW D AH K UW
BIODIESEL	B AY AH D IY S AH L
LM EH L EH M
DIFFERENT'	D IH F ER AH N T
DIFFERENT'(2)	D IH F R AH N T
UNTALENTED	AH N T AE L AH N T IH D
AIT AH AY T IY
FIELDING'	F IY L D IH NG
WUN	W AH N
CLAUDIA'S	K L AO D IY AH Z
TEXTING	T EH K S T IH NG
STAR'	S T AA R
PCP P IY S IY P IY
XZ EH K S Z IY
TELECONFERENCES	T EH L AH K AA N F AH R AH N S IH Z
MONTRI	M AA N T R IY
NOUGHT	N AO T
APPENDICES	AH P EH N D IH K S IH Z
DEMOTIVATE	D IY M OW T IH V AH T
BRITTNEY	B R IH T N IY
BENZYLPENICILLIN	B IH N Z IH L P AH N AH S IH L AH N
BLOGGING	B L AO G IH NG
NGC EH N JH IY S IY
CTO S IY T IY OW
SMS EH S EH M EH S
HEALTHILY	HH EH L TH IY L IY
CPU S IY P IY Y UW
STEPDAD	S T EH P D AE D
BOOMZ	B UW M Z
MULTIFUNCTIONAL	M AH L T IY F AH NG K SH AH N AH L
BRYONIA	B R AY OW N Y AH
GAZELLE'S	G AH Z EH L Z
MAY'VE	M EY V
USB Y UW EH S B IY
AMPICILLIN	AE M P AH S IH L AH N
NATE'S	N EY T S
ECOTOURISM	EH K AH T OW Y AH R IH Z AH M
EMMA'	EH M AH
BATTLESTAR	B AE T AH L AH S T ER
SAMANTHA'S	S AH M AE N TH AH Z
QDE K Y UW D IY IY
DEADLINE'S	D EH D L AY N Z
US'	AH S
US'(2)	Y UW EH S
KOCHI	K AA CH IY
ABYSS'	AH B IH S
TO'VE	T UW V
BILL'	B IH L
FRIENDED	F R EH N D IH D
FLOORHANDS	F L OW R HH AE N D Z
UNAMBITIOUS	AH N AE M B IH SH AH S
SUPERFLY'	S UW P ER F L AY
WORKSPACE	W ER K S P EY S
PREBBLE'S	P R EH B AH L Z
TRASTEVERE	T R AE S T IY V AH R
AGROUND'	AH G R AW N D
WI	W IY
GULLFOSS	G AH L F AH S
BEDROOM'S	B EH D R UW M Z
INTRAMUSCULAR	IH N T R AH M AH S K Y AH L ER
RUNNER'	R AH N ER
MUMBAI	M UH M B AY
WEBSITES	W EH B S AY T S
AVATAR'	AE V AH T AA R
NAK	N AE K
REFORMATTED	R IY F AO R M AE T IH D
CHART'S	CH AA R T S
ISADORA	AH S AE D AH R AH
AIBILEEN	EY B AH L AH N
OVERSTAYING	OW V ER S T EY IH NG
SEB S EH B
BATHROOM'S	B AE TH R UW M Z
MONTMARTRE	M AA N M AE R T R AH
XIN	Z IH N
